@startuml
hide empty description
state acpydr
[*] --> acpydr : zbdsj
acpydr --> bspcgk : bpouq
state icetkq <<choice>>
bspcgk --> icetkq : adyyq
icetkq --> ovnnhn : xdjm
ovnnhn --> mtlggt : zlhwv
mtlggt --> hzrxwo : meecr
hzrxwo --> kztfsl : snsqmra
icetkq --> kzrlyl : eaop
kzrlyl --> gjmdpg : diizs
gjmdpg --> euutko : pyvnw
euutko --> kztfsl : mqbfemn
kztfsl --> cqavqk : rwbut
cqavqk --> ugmljb : ruusf
ugmljb --> otvaqw : tsyon
state syjoao <<choice>>
otvaqw --> syjoao : lbrwp
syjoao --> bkewsd : ieda
bkewsd --> ewucwg : nwjoh
ewucwg --> xqpnkv : dknfsgf
syjoao --> oucibf : kjlo
oucibf --> wtkvib : bqkux
wtkvib --> xehyjn : smyfy
xehyjn --> mqkcek : pcoar
mqkcek --> xqpnkv : edlhojo
syjoao --> zrfbfv : nenm
zrfbfv --> phiqdn : gqdsc
phiqdn --> dxvjql : ocadq
dxvjql --> xqpnkv : qkzkflb
xqpnkv --> zriizx : cktnn
zriizx --> ldzzfg : uyryp
ldzzfg --> arihfc : ovgsu
arihfc --> nlfnuh : ltuey
nlfnuh --> akrzri : vxylm
akrzri --> eyzyib : iasge
state nudlzb <<choice>>
eyzyib --> nudlzb : kqpho
nudlzb --> nbcymu : azgr
nbcymu --> vizeyu : tatmj
vizeyu --> lygtwh : jgsgu
lygtwh --> bcjzbe : ruqnj
bcjzbe --> ymsepo : aitmfwo
nudlzb --> ljmqbr : pski
ljmqbr --> xgayms : lbbwz
xgayms --> xqynyh : rqcst
xqynyh --> ymsepo : zzntabg
ymsepo --> llgkim : qbexz
llgkim --> [*] : betwv
@enduml