@startuml
state qjeobr
[*] --> qjeobr : rcnfa
qjeobr --> cfomiq : erqhg
state oyzcgd <<choice>>
cfomiq --> oyzcgd : fhuiw
oyzcgd --> vhkwcf : jsft
vhkwcf --> gkdhvv : njabf
gkdhvv --> gcjtqd : odkbgpn
oyzcgd --> ufoati : sspe
ufoati --> eqjnvs : yohla
eqjnvs --> natrci : zlhoz
natrci --> gcjtqd : niefxjx
state vmqycu <<fork>>
gcjtqd --> vmqycu : lntur
state ntnkoq <<join>>
vmqycu --> kjnfdf : gctv
kjnfdf --> dmseti : lzdpp
dmseti --> qpijis : vqoqn
qpijis --> hwbohn : vupdo
hwbohn --> ntnkoq : pjbszsz
vmqycu --> obbojg : ofls
obbojg --> zlrusz : vsano
zlrusz --> auodcq : mgjmc
auodcq --> ntnkoq : xfuymgn
ntnkoq --> aanicr : zpjci
aanicr --> vvlxfq : nrriy
vvlxfq --> uxyxbz : codmd
uxyxbz --> rxvswi : xtozi
@enduml