@startuml
hide empty description
state roriop
[*] --> roriop : qzvut
roriop --> mtbhhg : tlmnk
mtbhhg --> zwbjqb : xlnhd
state fqznjm <<choice>>
zwbjqb --> fqznjm : lljve
fqznjm --> cfdzcg : mulw
cfdzcg --> qfvweu : htozm
qfvweu --> tjglus : uwplxhy
fqznjm --> ikizkm : nkir
ikizkm --> nnsaua : gmajd
nnsaua --> boexue : bamgs
boexue --> tjglus : tixbmqr
state cnhvrx <<choice>>
tjglus --> cnhvrx : ppbpz
cnhvrx --> cmyxmq : vpjf
cmyxmq --> dcbmnw : puunw
dcbmnw --> xqyisd : tmqga
xqyisd --> wunckm : xnwlbdd
cnhvrx --> ysxciy : spwj
ysxciy --> jxzgbe : mkpcs
jxzgbe --> eegflf : cslgl
eegflf --> nrudlh : ukbkw
nrudlh --> wunckm : zebqvje
wunckm --> pmcwjc : nsvcs
pmcwjc --> oeogab : gzqvm
oeogab --> rosaqz : fiplb
state rosaqz {
rsehlf --> omcnly : zldef
omcnly --> cooung : kghkm
cooung --> [*] : nlfbf
}
rosaqz --> uikidr : yznyr
uikidr --> deybff : tgrmb
deybff --> ahbehg : yedap
ahbehg --> ujslkk : anerc
ujslkk --> rutahk : ajjdg
rutahk --> akpesn : mexkf
akpesn --> swemsx : jvcmw
swemsx --> [*] : tjiji
@enduml