@startuml
state cbtnab
[*] --> cbtnab : mveks
cbtnab --> aafxuk : amgnj
aafxuk --> xvpcmg : sglyc
xvpcmg --> ixbvlh : lxetj
ixbvlh --> vowcvv : hngsb
vowcvv --> nwmqbb : uqmfk
nwmqbb --> bvlskv : woyqs
bvlskv --> lmptbx : rpimy
lmptbx --> krlxls : imhxn
state qvppqo <<choice>>
krlxls --> qvppqo : lrdue
qvppqo --> nhulvf : iokf
nhulvf --> tiduep : lrblb
tiduep --> nalmrm : ihiep
nalmrm --> ymtmfd : dtokf
ymtmfd --> gmhodb : fdwnhxm
qvppqo --> zwcmgl : ifjm
zwcmgl --> waueng : bwqbj
waueng --> eogwld : nqyxq
eogwld --> mgfbvk : uvast
mgfbvk --> gmhodb : ilewhlm
qvppqo --> madgmr : ogdg
madgmr --> apjggk : zvowq
apjggk --> fffmze : juoba
fffmze --> semarj : lyrsn
semarj --> gmhodb : jjyaefr
state uklqys <<choice>>
gmhodb --> uklqys : cbpnc
uklqys --> qguiap : fzqj
qguiap --> ofaqnt : saxgl
ofaqnt --> xolhjk : cbncb
xolhjk --> lmxyoc : mdxlc
lmxyoc --> snrwxo : qymmnsd
uklqys --> yycpqa : tegu
yycpqa --> oauukb : ecfda
oauukb --> ewvtcf : xrxdt
ewvtcf --> rkezcm : tssev
rkezcm --> snrwxo : kflnyda
uklqys --> ceycou : cveo
ceycou --> qfvibg : jeotz
qfvibg --> hqadxs : nfrel
hqadxs --> gfmadg : ipitr
gfmadg --> snrwxo : nlskfbu
snrwxo --> kaawxt : iuqkp
kaawxt --> xhdmoz : eoggo
xhdmoz --> qglvkm : gqpbv
qglvkm --> verenc : aebin
@enduml