@startuml
hide empty description
state pfgwwn
pfgwwn --> xqmylj : efpas
xqmylj --> cggnve : nwtyd
cggnve --> rhocqv : aqfax
state enxmlh <<fork>>
rhocqv --> enxmlh : ursfj
state zirwmn <<join>>
enxmlh --> yjmcgx : cdfy
yjmcgx --> acqnai : wokoi
acqnai --> oduhft : xytez
oduhft --> fbmjsq : fqxyp
fbmjsq --> zirwmn : osqjyha
enxmlh --> azboap : wido
azboap --> vqoinu : ziont
vqoinu --> rkcnhf : odtma
rkcnhf --> xkykja : tmfma
xkykja --> zirwmn : jrizrko
zirwmn --> chzasu : aposj
state oauxlw <<choice>>
chzasu --> oauxlw : qbtns
oauxlw --> lxxbwm : omda
lxxbwm --> xcwidz : fpzzw
xcwidz --> cgkmtc : cvimr
cgkmtc --> ismyzv : pmtnner
oauxlw --> chzgoy : tsae
chzgoy --> edjjzr : gjkuq
edjjzr --> spvxig : xwkyw
spvxig --> sigupf : pqfcl
sigupf --> ismyzv : wvwbegc
oauxlw --> hrjmmj : pgrb
hrjmmj --> onexgc : qusos
onexgc --> yqrhof : veizu
yqrhof --> ismyzv : bsyhuur
ismyzv --> hfbnqk : rrumz
hfbnqk --> [*] : auubk
@enduml