@startuml
hide empty description
state mqwmbl
[*] --> mqwmbl : ylqal
mqwmbl --> yefasw : fwiel
state yefasw {
[*] --> xguers : vslkr
xguers --> xfkppn : yplzi
xfkppn --> [*] : xkppe
}
yefasw --> fsqeej : kwwcx
fsqeej --> frseyu : hxqpi
state mszpws <<fork>>
frseyu --> mszpws : riilg
state zagkja <<join>>
mszpws --> jveeco : ikui
jveeco --> eubkun : chxnt
eubkun --> elwrbn : fmesm
elwrbn --> zagkja : zxhwhdm
mszpws --> zfgmup : lzmr
zfgmup --> gpsjno : mpoyq
gpsjno --> ngoaps : xppll
ngoaps --> odwubk : xkfna
odwubk --> zagkja : jolcnww
mszpws --> bkofpr : tquj
bkofpr --> ucundy : jpkog
ucundy --> dtijvq : tmopg
dtijvq --> zagkja : vsfurxk
state fqnbtv <<fork>>
zagkja --> fqnbtv : efobz
state kbhzwb <<join>>
fqnbtv --> owbpgj : fqjy
owbpgj --> hfmhba : uqnin
hfmhba --> ynwigf : nxqzl
ynwigf --> csradt : rxyty
csradt --> kbhzwb : euocibd
fqnbtv --> lihxcx : kfcq
lihxcx --> zqvsaq : fjjqc
zqvsaq --> duiluc : dkjbw
duiluc --> pcwsdh : kkyrd
pcwsdh --> kbhzwb : cksjdve
kbhzwb --> vtpyrq : xcofw
state qvybfe <<choice>>
vtpyrq --> qvybfe : cjmtt
qvybfe --> nknlin : brtv
nknlin --> kyfvml : jwnvm
kyfvml --> jhocmb : yqlig
jhocmb --> iighuf : mwxqw
iighuf --> hrhjng : bvsbmqn
qvybfe --> sieilg : nbsk
sieilg --> idoeqs : nvimn
idoeqs --> jvhpqi : qrsfd
jvhpqi --> hrhjng : gkwcggn
hrhjng --> bumawb : nbipe
bumawb --> wuxxzw : fftqx
wuxxzw --> [*] : wgjmc
@enduml