@startuml
hide empty description
state wyydzz
wyydzz --> rksagv : kqrrr
rksagv --> zmofcc : ykzoa
zmofcc --> upzaac : uabnn
upzaac --> etfcda : zghde
etfcda --> oyivlk : gmsfi
state oyivlk {
[*] --> hylwze : rrsds
hylwze --> iitcgv : myexl
iitcgv --> upeboj : vabne
upeboj --> tlqfpo : lmxun
tlqfpo --> [*] : vmzcu
}
state aaswvb <<fork>>
oyivlk --> aaswvb : skuil
state mgfegy <<join>>
aaswvb --> hzwmpr : ives
hzwmpr --> douiqk : aegve
douiqk --> jttcae : zcfzw
jttcae --> mgfegy : fjmusfp
aaswvb --> vwtncg : ldur
vwtncg --> tbekmu : mdwxf
tbekmu --> ncbswm : xiibb
ncbswm --> owqiiy : jfsar
owqiiy --> mgfegy : rgnvtlm
aaswvb --> fxtict : fpmd
fxtict --> aeainj : otgpn
aeainj --> hnppcf : muozv
hnppcf --> ppgahn : fyhvs
ppgahn --> mgfegy : ivxgsis
mgfegy --> nydnal : ucffz
nydnal --> [*] : ltdfn
@enduml