@startuml
state piyzex
piyzex --> vobczr : qavdy
state yojopx <<choice>>
vobczr --> yojopx : mranp
yojopx --> arqebk : epql
arqebk --> vrxmtz : mvlbi
vrxmtz --> zlddqu : hboxnss
yojopx --> cilsxk : hxdh
cilsxk --> qbdqaz : qrwnt
qbdqaz --> abwavb : cubah
abwavb --> feusdg : zoksk
feusdg --> zlddqu : lukshjb
yojopx --> svgenh : qpvn
svgenh --> yxilvq : jwtji
yxilvq --> nlyvai : xhzqw
nlyvai --> zlddqu : gwdkwln
zlddqu --> lmydpf : dgdzx
lmydpf --> lfiwlf : gqiaf
lfiwlf --> gutvsl : crubz
state awyvet <<choice>>
gutvsl --> awyvet : aosay
awyvet --> qjnpet : szfj
qjnpet --> udmlqj : dkgpg
udmlqj --> clzzyj : efgob
clzzyj --> zmbmiu : sadii
zmbmiu --> rjmmtn : jqtswby
awyvet --> wtudqz : wgos
wtudqz --> yrkset : ixmcg
yrkset --> uwoeez : maxwq
uwoeez --> rjmmtn : szysgzg
rjmmtn --> rzgpyl : yijtp
rzgpyl --> bskdsi : rsnaf
state bskdsi {
qfxpir --> bomkxf : krijf
bomkxf --> wqrouf : bqqru
wqrouf --> [*] : edsrp
}
bskdsi --> vwjefh : fbwct
@enduml