@startuml
state cjqkrh
[*] --> cjqkrh : avwcv
cjqkrh --> jfxpwl : aphyp
state jfxpwl {
zvqaws --> anjrxu : uhjpo
}
state tygexf <<fork>>
jfxpwl --> tygexf : vvlwg
state etcpku <<join>>
tygexf --> jbfjzq : hvqj
jbfjzq --> cneabu : ddwrn
cneabu --> etcpku : fhfivqt
tygexf --> txebgv : jzgb
txebgv --> isqwlc : oetdl
isqwlc --> chevpm : ucegj
chevpm --> etcpku : osfdirk
etcpku --> zgyjfr : ururi
zgyjfr --> ziomkb : cvrlt
ziomkb --> tufoen : iobek
tufoen --> gzlong : pvmgc
gzlong --> fmjprk : ezuuk
fmjprk --> aerdri : kymue
aerdri --> opyykm : keamx
opyykm --> dkrjus : qzmdi
dkrjus --> yjfakk : tlmpa
yjfakk --> qyrcix : qdeuv
qyrcix --> ympelb : ayjau
ympelb --> vwdtvm : uzdmz
vwdtvm --> uhtcnj : dsheu
uhtcnj --> [*] : mefav
@enduml