@startuml
state bldgmn
[*] --> bldgmn : dyrjs
bldgmn --> apteed : izjwe
apteed --> uyjule : wjrhq
uyjule --> wlgzfs : xfurl
state jxpkvj <<fork>>
wlgzfs --> jxpkvj : cdxkg
state xaggmp <<join>>
jxpkvj --> mhatjt : nanq
mhatjt --> hnnxae : inyqw
hnnxae --> iuqdvz : nosjp
iuqdvz --> xaggmp : vcgwrsl
jxpkvj --> mdcacw : uaam
mdcacw --> jmheur : wzufl
jmheur --> gouckn : twcay
gouckn --> gzpeyn : xlgle
gzpeyn --> xaggmp : ykqmcva
jxpkvj --> jlpkvd : xpmq
jlpkvd --> asozjw : uxzrh
asozjw --> qghjro : pwboh
qghjro --> tcpqnm : hxmpr
tcpqnm --> xaggmp : bihsjyq
xaggmp --> mafsla : saolf
mafsla --> pdrlue : ilcng
pdrlue --> snvlst : orsuu
snvlst --> irvglc : svmnx
irvglc --> euvhip : ymwvx
euvhip --> hkcsus : hxmmn
state scolzv <<choice>>
hkcsus --> scolzv : cwxqa
scolzv --> yuptet : wqyr
yuptet --> pikixm : dmcni
pikixm --> ymzkdw : xpnnl
ymzkdw --> ltyyrw : tnfcv
ltyyrw --> tsjjqd : nnzakvd
scolzv --> ylcdwo : nmnl
ylcdwo --> ltgxng : saaqn
ltgxng --> tsjjqd : ubtpnid
tsjjqd --> vmaasr : oqmzr
vmaasr --> [*] : amgii
@enduml