@startuml
hide empty description
state mcfndc
mcfndc --> ooynlh : yluiu
ooynlh --> rpzbwg : btnlm
rpzbwg --> adeccu : jvgim
adeccu --> zzacja : qedfd
state kvkwcg <<choice>>
zzacja --> kvkwcg : mkjmq
kvkwcg --> sjynfs : ylsf
sjynfs --> phjndm : gxpop
phjndm --> cwszdb : stgpk
cwszdb --> jkdixn : glrybrt
kvkwcg --> ekhekr : fqaq
ekhekr --> sdyiiz : qlgfv
sdyiiz --> nsnwnd : gqgif
nsnwnd --> ukbcvm : nndke
ukbcvm --> jkdixn : mrfcqku
kvkwcg --> aaufxq : eirp
aaufxq --> eptpwn : ezfvl
eptpwn --> geiakj : gavjf
geiakj --> jkdixn : cdvvgzj
jkdixn --> axqvsg : tebxx
axqvsg --> zwrxwx : jjrju
state wemxul <<choice>>
zwrxwx --> wemxul : qbwaq
wemxul --> jmmvef : biyx
jmmvef --> kivqjq : hkmru
kivqjq --> iwmnzd : dhhqygd
wemxul --> fdakct : dead
fdakct --> tsmcet : tutcp
tsmcet --> fuvvvh : ioaop
fuvvvh --> zgcrsy : qniys
zgcrsy --> iwmnzd : lodsctc
iwmnzd --> byyerm : fzevt
@enduml