@startuml
state qfrqqq
[*] --> qfrqqq : mgqym
qfrqqq --> lzbsos : yazeh
state waoact <<choice>>
lzbsos --> waoact : grdqn
waoact --> sckvdy : qbju
sckvdy --> evzsyu : bhaha
evzsyu --> nxsnhx : zgmie
nxsnhx --> tcsnpf : hxhoz
tcsnpf --> mshtpa : ovkrgxp
waoact --> kuwflr : ofej
kuwflr --> kwrzka : oqtko
kwrzka --> qiavkb : pvfiq
qiavkb --> lcgwhp : hwfzy
lcgwhp --> mshtpa : vedrmsi
waoact --> nagsnl : fqtp
nagsnl --> pqvhat : qoium
pqvhat --> shdhks : knhvi
shdhks --> grddpd : dcwji
grddpd --> mshtpa : khgsclz
mshtpa --> nlfkjd : azozo
nlfkjd --> fkxauo : mnlht
fkxauo --> gxvmpq : cfqay
gxvmpq --> wcfntd : pzoio
wcfntd --> fpnvov : xaikb
fpnvov --> volwbi : puqek
volwbi --> fjrouh : zdmwh
state cqgcwi <<choice>>
fjrouh --> cqgcwi : qpapf
cqgcwi --> rpoosa : yixp
rpoosa --> uyaynt : ucmhi
uyaynt --> kryrtn : dhcqbhw
cqgcwi --> ynsnlt : mpqw
ynsnlt --> nuukre : mfqxa
nuukre --> leexvg : sdpdv
leexvg --> grksez : gnixw
grksez --> kryrtn : ypognnn
@enduml