@startuml
hide empty description
state iwnngp
[*] --> iwnngp : sehht
state izzbpu <<choice>>
iwnngp --> izzbpu : xaqfw
izzbpu --> xifqbw : onnv
xifqbw --> czrvjw : xtoyx
czrvjw --> cuzhjk : mquro
cuzhjk --> qyancr : aocuj
qyancr --> oozwba : fitqakk
izzbpu --> jfvmyl : xgdo
jfvmyl --> nyohvg : bsmow
nyohvg --> oozwba : rphlbmu
oozwba --> xgrcox : xqtes
xgrcox --> ujbzzb : fpxvw
ujbzzb --> jpiwnr : elfqj
jpiwnr --> fnpmus : zrpag
fnpmus --> xujnct : uibnw
xujnct --> qmhxuq : iuqcq
qmhxuq --> ibnkts : afrca
state ibnkts {
[*] --> nikfdo : kfior
nikfdo --> zeeegu : tkect
zeeegu --> prbdws : ognnd
}
ibnkts --> bhuphs : imnub
bhuphs --> ouwhbj : qkkef
ouwhbj --> dyahnq : naadm
state twhjbj <<fork>>
dyahnq --> twhjbj : ruqib
state kgqqni <<join>>
twhjbj --> bbwquh : casv
bbwquh --> tlbywe : ytqin
tlbywe --> fjzkyz : bvhzw
fjzkyz --> kgqqni : dbuqpij
twhjbj --> hsdawt : mgbx
hsdawt --> hnzxgl : jxmhs
hnzxgl --> kgqqni : noltwpq
@enduml