@startuml
hide empty description
state tmeuim
state dskvgk <<fork>>
tmeuim --> dskvgk : jxxec
state sxkzje <<join>>
dskvgk --> sdvlyp : zywa
sdvlyp --> gchzqk : msiyh
gchzqk --> kxkdlf : bdpgz
kxkdlf --> baerbn : hvhkf
baerbn --> sxkzje : qxnrlbe
dskvgk --> hjselg : mgrm
hjselg --> pnwzxw : pbydu
pnwzxw --> sxkzje : ejxqjtu
sxkzje --> vbcphj : tgmgh
vbcphj --> wbduey : awgtc
wbduey --> yfgefi : iyxjp
yfgefi --> wjvxlv : rtvlv
wjvxlv --> utmgqe : qwbas
utmgqe --> quaffk : jnkfm
state rkrogl <<choice>>
quaffk --> rkrogl : lmias
rkrogl --> koteah : adyu
koteah --> wvaydx : eshkd
wvaydx --> cnmfta : mmltq
cnmfta --> fbouwn : kltogae
rkrogl --> ehdotd : pvhe
ehdotd --> leemer : csxyk
leemer --> wsvmsg : feoyg
wsvmsg --> guswpq : dlwsq
guswpq --> fbouwn : vxlrljg
rkrogl --> bftuxy : loqo
bftuxy --> ojcelh : gvjdx
ojcelh --> ujpwlw : jgtnh
ujpwlw --> fbouwn : gxvfyid
fbouwn --> hvoeup : cvxou
hvoeup --> idkvph : xsivw
@enduml