@startuml
hide empty description
state hwvnsh
hwvnsh --> wuckjr : fjnoy
state wuckjr {
mongtw --> hnemza : zjeum
hnemza --> mllnou : tbouv
mllnou --> [*] : qwkyv
}
wuckjr --> nhrtnk : cmxvp
nhrtnk --> iisgtp : nfrbr
iisgtp --> rufuli : buakl
rufuli --> qetyyt : hhars
qetyyt --> raskni : ttooh
state djpnik <<choice>>
raskni --> djpnik : rzxag
djpnik --> wwjraz : guwt
wwjraz --> iklpuq : vrlfw
iklpuq --> htjxrs : hhkcp
htjxrs --> pjbere : dvbrbqn
djpnik --> crxblv : gjvu
crxblv --> ryoaug : iplna
ryoaug --> pjbere : zzgpgxp
djpnik --> thdlyk : hefb
thdlyk --> dunaoc : snvbx
dunaoc --> idjscd : fgbih
idjscd --> pjbere : nldtrvp
pjbere --> gxiark : rrlpy
gxiark --> ruuklk : cgbln
state ruuklk {
srvmdf --> zzrdss : amebg
zzrdss --> xwqttt : bnsvv
xwqttt --> valbox : aauin
}
ruuklk --> menogz : uotro
menogz --> btaevx : sratj
btaevx --> ajebzv : fhubn
ajebzv --> awgmwe : gkcfd
awgmwe --> iyyibe : eajvz
iyyibe --> wwxehq : vkumd
wwxehq --> mozyrj : pjkdg
mozyrj --> [*] : jerdd
@enduml