@startuml
state jqgfkq
[*] --> jqgfkq : tliyk
jqgfkq --> svlmhy : vuafw
state hjxntu <<fork>>
svlmhy --> hjxntu : rchfu
state stwcnf <<join>>
hjxntu --> dauuuy : xopo
dauuuy --> ufjxul : dxyvo
ufjxul --> idotrv : gzjcy
idotrv --> stwcnf : akogucb
hjxntu --> yjtmom : vvya
yjtmom --> rpbyeh : rlpdz
rpbyeh --> kjofkg : bxwhh
kjofkg --> ioermh : sibhv
ioermh --> stwcnf : mjfujub
stwcnf --> qwlnde : acelx
state qwlnde {
vdqdgs --> qpoxuw : cssdx
qpoxuw --> cncovi : tjdsa
}
qwlnde --> ansvpm : lhjct
ansvpm --> wngmlr : oikns
wngmlr --> krmqfr : iakbs
krmqfr --> phefex : qrbvf
state phefex {
wsicyu --> jpsyzi : cckno
jpsyzi --> ycxldj : riviu
ycxldj --> [*] : ckufq
}
phefex --> iwcthd : timpm
iwcthd --> kskqiv : ihwlq
@enduml