@startuml
state wulkzf
wulkzf --> kqsepb : sgehm
state kqsepb {
yfdivg --> brhbsj : sxvxu
brhbsj --> vzcxlf : tdfpm
vzcxlf --> cbvrvz : uzfhn
cbvrvz --> [*] : mczvw
}
kqsepb --> cfzkxz : wixhp
cfzkxz --> xfmwff : ocbpa
state gpdlvp <<fork>>
xfmwff --> gpdlvp : qvoer
state ilghnd <<join>>
gpdlvp --> oquatz : toyj
oquatz --> extjoq : cbqsu
extjoq --> ilghnd : fhoiwnf
gpdlvp --> zacvle : aliu
zacvle --> psdbvq : ikgip
psdbvq --> ilghnd : wvxofwf
ilghnd --> ecqaeb : lzeqh
ecqaeb --> bdberz : cqprn
bdberz --> chqegk : dutcc
chqegk --> nyijua : igroj
state nyijua {
wpxqwp --> pineso : eqmov
pineso --> aehwri : sykrt
}
nyijua --> feklne : mwspf
feklne --> qjsldv : uhfto
qjsldv --> xuzugw : ughqc
xuzugw --> woytev : rlhhf
woytev --> ulsnhf : flhqa
ulsnhf --> vacmit : iiyun
vacmit --> yvxbrb : vttyq
@enduml