@startuml
state kngpwx
[*] --> kngpwx : xuacq
kngpwx --> dvudvp : iihzq
dvudvp --> hwicok : oqpgn
hwicok --> wjbday : xwnqs
wjbday --> uqxaay : soesv
state uqxaay {
[*] --> dbkaru : fdlsn
dbkaru --> tkwdpv : ypnxj
tkwdpv --> naqtyc : wyatv
naqtyc --> yowrtm : zoibt
}
uqxaay --> shyigx : wotlx
shyigx --> givrso : btfpg
givrso --> dgqqlh : moega
state dgqqlh {
npipgr --> mndpem : lkkqq
mndpem --> glbdbf : liyqo
glbdbf --> [*] : liqxr
}
dgqqlh --> jiwlpg : cubhc
jiwlpg --> qmraee : litnx
qmraee --> eyykdl : cmpbn
eyykdl --> nujiwl : klizq
nujiwl --> uqckun : xbrtt
uqckun --> ytrhui : bwrco
ytrhui --> rgrwmt : rxcyu
rgrwmt --> [*] : astvd
@enduml