@startuml
hide empty description
state kecypl
kecypl --> ztdkvs : hyxoa
state njwlqr <<fork>>
ztdkvs --> njwlqr : epahc
state paohpt <<join>>
njwlqr --> vpbysm : jcvl
vpbysm --> rycpcq : klgqj
rycpcq --> paohpt : nmypbml
njwlqr --> hoqusj : rtkd
hoqusj --> jputow : fiywt
jputow --> sezrgv : ojkga
sezrgv --> skivks : kpnsv
skivks --> paohpt : xjmxmrj
njwlqr --> xxstmh : luvz
xxstmh --> yrwvod : nopea
yrwvod --> sbdtjt : xhvkg
sbdtjt --> paohpt : wyiapcy
paohpt --> qppvyp : jalgl
qppvyp --> oxsmwd : wuqty
oxsmwd --> fidvwx : kcsqx
fidvwx --> kvljzz : gwbrm
kvljzz --> nncokl : xxwdi
nncokl --> tvejhg : zevxo
tvejhg --> qqkwge : sikly
qqkwge --> umvira : bsrwk
umvira --> szqpjw : twhqd
state udpvup <<fork>>
szqpjw --> udpvup : fpmwq
state gvrzyh <<join>>
udpvup --> zxbzbb : cuxy
zxbzbb --> oumkew : igaxi
oumkew --> dprjcy : wdktm
dprjcy --> gvrzyh : tzxkcmq
udpvup --> fmxark : mvad
fmxark --> kczmpz : lwzzy
kczmpz --> gvrzyh : pgeqrbd
state lhsmgb <<fork>>
gvrzyh --> lhsmgb : lttiz
state vubknl <<join>>
lhsmgb --> snkmny : ijwu
snkmny --> qgqiye : zoyze
qgqiye --> mhsulz : ehyur
mhsulz --> vubknl : onqiyvg
lhsmgb --> ptqthc : ypcq
ptqthc --> fsorni : ktenf
fsorni --> gjbidi : eggam
gjbidi --> voexpa : vjbzm
voexpa --> vubknl : yuqfbcf
vubknl --> swrdjk : dbeys
swrdjk --> kjqvxw : nxsej
@enduml