@startuml
state vqzbep
[*] --> vqzbep : dsqlf
vqzbep --> axqrop : zvxwa
axqrop --> mttvvp : wqetq
state mzslcm <<choice>>
mttvvp --> mzslcm : hqjyd
mzslcm --> jgdfri : wwxf
jgdfri --> atetgl : xrudf
atetgl --> ulpkbf : glwdbhm
mzslcm --> cmqsnt : jlke
cmqsnt --> hrsojp : lttye
hrsojp --> tjzhpy : bnfii
tjzhpy --> yzgkqv : ceicg
yzgkqv --> ulpkbf : mgtsdpg
mzslcm --> txtgkd : qovn
txtgkd --> bovinp : ogwfe
bovinp --> ulpkbf : wcbmmhs
ulpkbf --> wqepbu : xbhzb
wqepbu --> nlawzs : iwmwm
nlawzs --> jqitnf : dbxoj
jqitnf --> ulvrbj : ozsqk
ulvrbj --> xxuncx : mfhip
xxuncx --> ymhnwx : ajocc
ymhnwx --> pnthii : htkys
pnthii --> qndixf : spxux
qndixf --> swxcsf : qibnq
swxcsf --> qngmev : swvwo
qngmev --> bclsax : tovkr
bclsax --> czzlwn : knukd
czzlwn --> yojfqi : arzsh
yojfqi --> [*] : feasw
@enduml