@startuml
state fldjlc
[*] --> fldjlc : xmyql
fldjlc --> ezfpis : vdrfm
ezfpis --> tedybn : sfcss
tedybn --> yjsvlq : osfqd
yjsvlq --> aretpu : cicil
state wqatbx <<choice>>
aretpu --> wqatbx : uorpp
wqatbx --> zxkebl : feoj
zxkebl --> bueano : ropgm
bueano --> ffdnfa : nonpyha
wqatbx --> mlqurt : lcnq
mlqurt --> plfbpz : yxust
plfbpz --> xwjkec : spobj
xwjkec --> yzpzwf : vyhsc
yzpzwf --> ffdnfa : zosbtww
wqatbx --> vptijv : rysw
vptijv --> khrryd : bpyyu
khrryd --> wmyvcz : sgxcg
wmyvcz --> pnpfqg : wswca
pnpfqg --> ffdnfa : nxxjssn
ffdnfa --> eagejz : anbxi
state sxgvfw <<fork>>
eagejz --> sxgvfw : oockg
state mqyfpm <<join>>
sxgvfw --> aoceed : yqms
aoceed --> xefnwa : bdnut
xefnwa --> jttkqy : cugbq
jttkqy --> mqyfpm : evloqqa
sxgvfw --> rqlnsx : qlcf
rqlnsx --> ljpkuu : bboen
ljpkuu --> aympwx : ryibf
aympwx --> mqyfpm : lowaxel
mqyfpm --> fefgvl : laksg
fefgvl --> zqpzbj : afdyi
zqpzbj --> fxhefi : ksgrm
@enduml