@startuml
state eiicrq
[*] --> eiicrq : ukixg
eiicrq --> njukei : glgzc
njukei --> qncdnx : cewip
qncdnx --> ldibyb : jlrhj
ldibyb --> egsuod : cdnpo
egsuod --> pqpstc : rhuqk
pqpstc --> gbhmtv : xhdah
state qmpywl <<fork>>
gbhmtv --> qmpywl : rqhol
state rmdxqs <<join>>
qmpywl --> cbsxqp : pfer
cbsxqp --> fzgeme : dekjh
fzgeme --> rmdxqs : nilykrw
qmpywl --> cunptg : tsyw
cunptg --> nxsien : bhnzt
nxsien --> rmdxqs : ctqkfvo
state jizmiv <<choice>>
rmdxqs --> jizmiv : iblor
jizmiv --> tnzxpr : twtj
tnzxpr --> hxpojm : nahpl
hxpojm --> vjlwio : hcjoc
vjlwio --> ycoqbu : vagva
ycoqbu --> stoswo : cparpgi
jizmiv --> eoilhr : stiz
eoilhr --> iwoezx : pnsxd
iwoezx --> stoswo : vuzukfl
jizmiv --> kszkvt : dzuv
kszkvt --> vjgafv : oajuj
vjgafv --> stoswo : uriwysa
stoswo --> ecomke : vejrd
state yddeiz <<fork>>
ecomke --> yddeiz : pibif
state pujmfd <<join>>
yddeiz --> nvbbin : bvnk
nvbbin --> iprnyc : nbixj
iprnyc --> nhjhqx : bedjp
nhjhqx --> gipmdm : ikwoa
gipmdm --> pujmfd : roerxme
yddeiz --> htstrg : kxlm
htstrg --> urqids : kzetf
urqids --> rgsymj : wkplg
rgsymj --> psjeaq : usbrl
psjeaq --> pujmfd : aacsevi
pujmfd --> yamecx : dttlz
yamecx --> xsseir : txnbb
xsseir --> srgoua : yzwnv
@enduml