@startuml
hide empty description
state fobibz
fobibz --> rxitdx : cxqqo
rxitdx --> dfoyyx : twvjr
state dfoyyx {
[*] --> rbkoiu : xwpue
rbkoiu --> ujjvoy : aqozp
ujjvoy --> atqjbh : zsnva
}
dfoyyx --> frijiy : yjyno
frijiy --> qjxrxw : qcmrk
qjxrxw --> jyaqjs : hqbvl
jyaqjs --> ycgqmp : aoiwk
ycgqmp --> ghquzp : twyoe
ghquzp --> suizgj : dlvma
state ljlfxy <<fork>>
suizgj --> ljlfxy : kvkqq
state eddtpo <<join>>
ljlfxy --> kwcybc : zyzg
kwcybc --> wkcsxz : gaard
wkcsxz --> kgincn : jzzeg
kgincn --> hcdnkq : zryew
hcdnkq --> eddtpo : xxazhct
ljlfxy --> kamkmx : twsa
kamkmx --> bnjalc : wyqob
bnjalc --> xzddbc : gpczv
xzddbc --> xzsuls : vdpna
xzsuls --> eddtpo : fmkyhcr
eddtpo --> gvqhwt : mzcry
gvqhwt --> uwhtdd : ixrqq
state pmzwgt <<choice>>
uwhtdd --> pmzwgt : wlkbs
pmzwgt --> ldsiyj : kpqw
ldsiyj --> muawsx : mokfh
muawsx --> mruydd : msaxq
mruydd --> nzbspv : zytbdld
pmzwgt --> pkicyd : hjlh
pkicyd --> cnehih : gkpty
cnehih --> zdqtrh : xivhd
zdqtrh --> caxgsk : vbryd
caxgsk --> nzbspv : okkxsmj
@enduml