@startuml
hide empty description
state xghoea
xghoea --> odhlwj : owuwr
odhlwj --> tsleaw : knyoq
tsleaw --> dimtpj : ukmza
dimtpj --> lfdmtr : gspaz
lfdmtr --> iuohmg : lyvvk
iuohmg --> yswrdm : qeaob
yswrdm --> urxxnl : uldzl
state urxxnl {
[*] --> cfzunk : qsioi
cfzunk --> sqpoiz : moiej
sqpoiz --> mozyja : gxpbr
mozyja --> irmuxi : mhjwx
}
urxxnl --> nggdpa : ttnwb
nggdpa --> eigucf : gnwlq
state vinjmt <<fork>>
eigucf --> vinjmt : ckqvm
state iaifqo <<join>>
vinjmt --> vfwgir : drgu
vfwgir --> ywiarx : qaibz
ywiarx --> upcjfh : xhnvl
upcjfh --> iaifqo : cuwjrgp
vinjmt --> rjmjgr : rgwf
rjmjgr --> nqexhy : qiwne
nqexhy --> uimevt : onxsn
uimevt --> olfxae : hiarw
olfxae --> iaifqo : tkaqoll
@enduml