@startuml
state xdmrci
xdmrci --> czyixa : nysjx
czyixa --> zmhyri : bagvl
zmhyri --> mwmyyy : uuxts
state lvljlo <<choice>>
mwmyyy --> lvljlo : zlbtm
lvljlo --> tivzuu : hxyq
tivzuu --> avzdqa : dlcur
avzdqa --> rmxqpv : kdntf
rmxqpv --> jzblsb : efovlac
lvljlo --> coixtd : kqbn
coixtd --> naefxw : krjgi
naefxw --> afhjdo : rfcyf
afhjdo --> jzblsb : lsqnpid
jzblsb --> hqgvav : pmkwe
hqgvav --> yqyohg : riiyt
state yqyohg {
rtpjcv --> iyexsq : sexsa
iyexsq --> hxydxh : eftks
hxydxh --> gjpswv : fwwhm
gjpswv --> [*] : cjsae
}
yqyohg --> ugtadu : hrsol
ugtadu --> bsonqm : wsbjh
state bsonqm {
[*] --> pojbba : yowcx
pojbba --> nkugeg : xtnqk
nkugeg --> dphckp : eefcq
}
state nysaph <<fork>>
bsonqm --> nysaph : gfrxd
state udupqc <<join>>
nysaph --> zqjdkx : rgdv
zqjdkx --> fpfsdc : wdcto
fpfsdc --> yeaktl : vyeah
yeaktl --> bopjkm : qlili
bopjkm --> udupqc : icausbv
nysaph --> lfzcta : xowp
lfzcta --> faivfq : xxsgt
faivfq --> ckegig : vvfbq
ckegig --> udupqc : xsrvggm
nysaph --> dasxfz : oydh
dasxfz --> izbjva : ehlun
izbjva --> udupqc : gtnpvfi
udupqc --> ekkfrj : dfdyt
ekkfrj --> nkjlap : dkyaw
nkjlap --> njjlcp : izlgq
njjlcp --> fyjpot : lctlt
state fyjpot {
[*] --> vfacpo : jgwcv
vfacpo --> acqtkn : jztiu
acqtkn --> dryavs : cbuqx
}
fyjpot --> tqhdhv : hqsgp
state tqhdhv {
frmfng --> cprkam : xedqq
cprkam --> epmdsv : nbyca
}
tqhdhv --> iuetsn : ietqk
iuetsn --> [*] : yyqfs
@enduml