@startuml
hide empty description
state ybovvi
[*] --> ybovvi : mhxvn
ybovvi --> znsiko : msjpm
znsiko --> rsxztz : aoaji
rsxztz --> rniodk : peqvg
rniodk --> liwmdk : roqaj
liwmdk --> vmzrct : kjngc
vmzrct --> ykfjto : wrhml
ykfjto --> brngxy : ihmjg
brngxy --> jagsrv : tgvgt
jagsrv --> raqntz : dhnnk
raqntz --> ghxybh : ocmni
ghxybh --> dtuqsp : tegtp
dtuqsp --> zncbrw : tmjpm
zncbrw --> yfeojk : tnqge
yfeojk --> phcgnf : uwpep
state ozyyxb <<choice>>
phcgnf --> ozyyxb : ddvqe
ozyyxb --> nwskof : laeg
nwskof --> yeronf : rtuhl
yeronf --> esrvco : ccnfd
esrvco --> fafihw : hfzgf
fafihw --> ddyupr : hpeysth
ozyyxb --> rqgfth : uare
rqgfth --> ftoxng : gkswo
ftoxng --> eqfcvs : pvqhn
eqfcvs --> ddyupr : uimgfog
ozyyxb --> lthgba : wwjy
lthgba --> sztlqv : btqco
sztlqv --> wlekve : wvvho
wlekve --> ddyupr : ajnoowp
ddyupr --> erajan : sjwqr
erajan --> [*] : wkqqg
@enduml