@startuml
state hgwamj
hgwamj --> gparje : ssclu
gparje --> owoftg : xmdbq
state dvujcz <<fork>>
owoftg --> dvujcz : fpmcq
state pkvitk <<join>>
dvujcz --> hozfts : xktq
hozfts --> skuoed : rwqho
skuoed --> qbgfqo : gcliv
qbgfqo --> pkvitk : uuxvhcp
dvujcz --> lqkcun : ojme
lqkcun --> tamlja : uzwpl
tamlja --> ujumxd : iscxf
ujumxd --> pkvitk : iyolyby
pkvitk --> tpwwvd : rplav
tpwwvd --> tuduuv : byqec
state tuduuv {
katmds --> vzblhn : nqfwq
vzblhn --> [*] : xowrj
}
tuduuv --> jtdhan : ztvhj
jtdhan --> etgvlu : lsbsr
etgvlu --> rtpbmr : svrqm
rtpbmr --> wavuhh : coyky
wavuhh --> zuswqo : mfolp
zuswqo --> vazvnc : gynjr
state vazvnc {
[*] --> gvpvxs : kmisv
gvpvxs --> irmjga : zbgib
irmjga --> [*] : suiwv
}
vazvnc --> jkxsma : gswlm
state nlqyuw <<fork>>
jkxsma --> nlqyuw : fhcnx
state zskprx <<join>>
nlqyuw --> vbujdw : edld
vbujdw --> ckebfx : jgtkj
ckebfx --> zskprx : nzhqmoi
nlqyuw --> isomvz : orjy
isomvz --> kbknrj : qqvxk
kbknrj --> rbzmxt : jithm
rbzmxt --> hsorit : cypia
hsorit --> zskprx : cyookkd
zskprx --> cejyka : mhstf
cejyka --> [*] : rwxwn
@enduml