@startuml
state lmhxny
[*] --> lmhxny : hzskp
lmhxny --> zbzeyl : bzxum
state zbzeyl {
bttstj --> mndknl : ccvzh
mndknl --> qvfysq : bfnts
qvfysq --> [*] : rxnpn
}
state uzmsaw <<fork>>
zbzeyl --> uzmsaw : mehfu
state ukbnwx <<join>>
uzmsaw --> nkyvsb : uzps
nkyvsb --> npxlxt : htsny
npxlxt --> xrtdgt : xnaay
xrtdgt --> ukbnwx : igbesfh
uzmsaw --> iwfcbd : xnes
iwfcbd --> ehethg : ezwtz
ehethg --> ukbnwx : zhduvgb
ukbnwx --> xnpphg : clpem
state xnpphg {
hnlyes --> widrpo : lfuwz
widrpo --> [*] : zpfxj
}
xnpphg --> arwrzw : yjdzc
arwrzw --> caapux : dhynz
state lpgwkl <<fork>>
caapux --> lpgwkl : vxqpk
state wmeahk <<join>>
lpgwkl --> vczvdu : ulgt
vczvdu --> eeoyzk : mfnxm
eeoyzk --> lrjrls : oorcy
lrjrls --> uwiwqy : qleti
uwiwqy --> wmeahk : gzpvykv
lpgwkl --> cpxlef : iwny
cpxlef --> iczdrg : cvtjf
iczdrg --> pwwljb : odjjb
pwwljb --> wmeahk : jvralee
lpgwkl --> iravrn : dkmj
iravrn --> iauwoz : hhgju
iauwoz --> jnijvy : xngja
jnijvy --> wmeahk : lkwmxqt
wmeahk --> brzhje : llhpx
brzhje --> bmxgsc : fogru
bmxgsc --> gyrbcn : elohw
gyrbcn --> fpjdsz : vnfcn
fpjdsz --> zjlaso : rkpnf
zjlaso --> ywzlyi : yjkvr
ywzlyi --> adzrzt : uhwlf
state jtreyw <<fork>>
adzrzt --> jtreyw : iugiv
state luvfpf <<join>>
jtreyw --> zgjoum : dcgf
zgjoum --> npbucg : ipsxc
npbucg --> httxrb : fhjsd
httxrb --> wjvrtq : zsqrt
wjvrtq --> luvfpf : ifkgnan
jtreyw --> mcdawf : bxdo
mcdawf --> rnubkg : xghzx
rnubkg --> luvfpf : yesegoj
jtreyw --> hedxqq : rzge
hedxqq --> pqnfss : dmlka
pqnfss --> usvlcr : qqkvb
usvlcr --> xqcnph : jslqd
xqcnph --> luvfpf : brnmrax
@enduml