@startuml
hide empty description
state fbocqz
[*] --> fbocqz : cybeo
fbocqz --> dltojc : xslra
dltojc --> fywrja : grqmz
state rdqiqz <<choice>>
fywrja --> rdqiqz : wkdft
rdqiqz --> bcased : ikor
bcased --> vijrqp : vyiue
vijrqp --> eyktpl : mjjzz
eyktpl --> heawxl : bpuehst
rdqiqz --> voqdlt : pjvk
voqdlt --> ttiqfs : ueixp
ttiqfs --> heawxl : opxntct
heawxl --> pdgjlb : lpvkr
state xsxqwg <<fork>>
pdgjlb --> xsxqwg : ldxcu
state ehivvj <<join>>
xsxqwg --> jodhjw : uxvl
jodhjw --> dtlqkn : upevb
dtlqkn --> ehivvj : enrphjz
xsxqwg --> sknkic : irgh
sknkic --> xlrjks : lfmzq
xlrjks --> ehivvj : weqkwxu
ehivvj --> kcvhzh : cxzqi
state glqnyw <<fork>>
kcvhzh --> glqnyw : bunwo
state fmghny <<join>>
glqnyw --> jfxgtg : msyw
jfxgtg --> dqxgek : pbqdq
dqxgek --> pwepdu : vphab
pwepdu --> fmghny : lfdomjw
glqnyw --> oihtcm : foke
oihtcm --> ixqcnf : rpwne
ixqcnf --> aqgmsy : sdfzy
aqgmsy --> ymzcmp : qtzyk
ymzcmp --> fmghny : wityzpy
fmghny --> [*] : javix
@enduml