@startuml
state rqhnab
[*] --> rqhnab : cvyhi
rqhnab --> supuim : hkmgj
supuim --> gtpoqs : exzcb
gtpoqs --> iqogul : zwuml
iqogul --> eajdpc : qrnav
state zwkgak <<choice>>
eajdpc --> zwkgak : seodq
zwkgak --> uwudpc : wvnx
uwudpc --> zdygru : lvlig
zdygru --> gikpih : ndpxw
gikpih --> peqgvi : gesez
peqgvi --> zuxwbv : uuoagze
zwkgak --> vdvtbv : dpfn
vdvtbv --> hodhuw : vlfua
hodhuw --> adwpkj : qwzwa
adwpkj --> zuxwbv : ogyneqn
zwkgak --> snshuf : iaoy
snshuf --> iavrzj : mymat
iavrzj --> fnlhed : mjmcc
fnlhed --> nwttkx : gtymp
nwttkx --> zuxwbv : iwergba
zuxwbv --> davmcq : csaiz
state davmcq {
[*] --> dmtoxg : ftbwq
dmtoxg --> wozgyt : xmdtx
wozgyt --> wobenr : utwen
wobenr --> ktaghs : zjlkl
}
davmcq --> lniffl : zrnrp
lniffl --> grkhyr : iexgz
grkhyr --> qggywz : rdzci
qggywz --> [*] : vgpwi
@enduml