@startuml
hide empty description
state cypjqz
cypjqz --> nifucm : yfbyv
state whgvdk <<choice>>
nifucm --> whgvdk : bzbbg
whgvdk --> etrlud : cyoa
etrlud --> youjph : vvmmt
youjph --> kfwsal : dgxaqpv
whgvdk --> rudztl : tbvz
rudztl --> xqjpcz : uvgyc
xqjpcz --> kfwsal : hgqcflf
kfwsal --> mkrqwj : lectw
mkrqwj --> prfdvv : rzdku
prfdvv --> eqerkk : duajs
eqerkk --> mzxysb : xoxge
mzxysb --> qkgkmm : zaqoz
qkgkmm --> bninjl : qedpb
bninjl --> mpyfoo : aedzv
state aqkhpp <<fork>>
mpyfoo --> aqkhpp : hghzi
state gywjir <<join>>
aqkhpp --> avwvay : jswt
avwvay --> ldsrkx : ptfpe
ldsrkx --> fxcuuj : hqdkp
fxcuuj --> oklvyj : hirgf
oklvyj --> gywjir : toepham
aqkhpp --> umzzvz : kndj
umzzvz --> jthhcq : xogzn
jthhcq --> yqtune : xuorl
yqtune --> okdwcp : hfvdz
okdwcp --> gywjir : wfyjgcl
aqkhpp --> yqnypd : mtuc
yqnypd --> gzulsx : lvdno
gzulsx --> mjfcfr : ifsnr
mjfcfr --> fvjqik : pxxil
fvjqik --> gywjir : ioeppnn
@enduml