@startuml
hide empty description
state becpzi
becpzi --> betclo : gxkwi
betclo --> uthoqo : zjmjs
uthoqo --> elthvr : koqfy
state zkrvuf <<fork>>
elthvr --> zkrvuf : hfgeq
state ixktpy <<join>>
zkrvuf --> vhakmk : fmdm
vhakmk --> ostcji : obplh
ostcji --> ogbapp : lbnvu
ogbapp --> inscbh : xkeas
inscbh --> ixktpy : winscfl
zkrvuf --> ijkqcq : hksi
ijkqcq --> acrnam : pyhts
acrnam --> gscmyi : mjszw
gscmyi --> najxoc : aupoo
najxoc --> ixktpy : ugizdaj
ixktpy --> lyqlqz : mruzx
state lyqlqz {
[*] --> mejymh : ruicu
mejymh --> oulljc : nhnlt
oulljc --> itvfvc : axmlf
itvfvc --> epxzjb : sejre
}
state ldotgb <<choice>>
lyqlqz --> ldotgb : klraq
ldotgb --> lqsonx : bghe
lqsonx --> zvvhgo : agiya
zvvhgo --> ljksaq : sdczh
ljksaq --> wmmcgu : euostun
ldotgb --> cafbuq : zcbj
cafbuq --> utrahd : pcxho
utrahd --> rkyznd : ntaow
rkyznd --> wmmcgu : zvpmlpz
wmmcgu --> grptdd : yqnzk
grptdd --> xjfzda : cmnxz
xjfzda --> hnwngo : pscxy
@enduml