@startuml
hide empty description
state mzyoon
[*] --> mzyoon : mpnxl
mzyoon --> wjdwjc : wjvsw
wjdwjc --> zbjede : guwbq
state zbjede {
[*] --> bzdloo : wuzcr
bzdloo --> mcgyzm : uhmzu
mcgyzm --> xtbjke : hydne
}
zbjede --> rqkqyo : kucmo
rqkqyo --> bdwill : gdnel
bdwill --> sdnsij : pncpw
sdnsij --> jwsyrt : engbb
state xvmhth <<fork>>
jwsyrt --> xvmhth : qquoo
state fxbeoa <<join>>
xvmhth --> pbdtbl : ffck
pbdtbl --> muwuyn : etxqd
muwuyn --> yaapcb : wtcqa
yaapcb --> jokkur : fyqwh
jokkur --> fxbeoa : freuoia
xvmhth --> ozrtkw : xmfh
ozrtkw --> mseptt : qibna
mseptt --> zpilmv : phecn
zpilmv --> tfbmci : ljdon
tfbmci --> fxbeoa : qtfvxdq
xvmhth --> bflrzg : tuwf
bflrzg --> webpca : brbsk
webpca --> fxbeoa : zqdbfwh
fxbeoa --> orskgz : jmbwm
orskgz --> pfoive : quiwo
@enduml