@startuml
hide empty description
state ahwbhn
[*] --> ahwbhn : dvzco
ahwbhn --> jyfbeu : hsdgu
jyfbeu --> wzengs : ragvd
wzengs --> dnbtzq : tndlu
dnbtzq --> cebzfe : snwrl
state cebzfe {
[*] --> vhsjok : modek
vhsjok --> gesyjo : uaxso
}
cebzfe --> erjvho : zlxsi
erjvho --> wgydoe : mllik
wgydoe --> ymjjms : dzcnm
state mmbyok <<fork>>
ymjjms --> mmbyok : phwpe
state iqcyva <<join>>
mmbyok --> wzbxwr : jxnl
wzbxwr --> wdwntg : kaqsk
wdwntg --> uzmslq : rjcpr
uzmslq --> fnwvek : roaqn
fnwvek --> iqcyva : dclghlk
mmbyok --> ueeuhb : llia
ueeuhb --> nacwbx : lzfge
nacwbx --> wytxax : lqhwm
wytxax --> dgyfsd : cebeg
dgyfsd --> iqcyva : lhwyvug
iqcyva --> sqdmbe : tfzgx
sqdmbe --> toddju : mloxe
toddju --> ohtsdu : mdfkm
ohtsdu --> nhgpwk : ztnxn
nhgpwk --> dvnexv : czexs
dvnexv --> izttst : euvox
@enduml