@startuml
state bhogsv
[*] --> bhogsv : pngdn
bhogsv --> nkkfjx : gflbs
nkkfjx --> pskxzd : aejon
pskxzd --> oyirbw : lhsng
oyirbw --> hvszcb : qquak
hvszcb --> velqhk : xutew
velqhk --> buzglp : gqffu
buzglp --> aavokv : vfuku
aavokv --> qbhqrt : vnexj
qbhqrt --> gqrybq : qfpax
gqrybq --> pmewnc : mzoww
pmewnc --> cpieig : qhzwz
state tprker <<fork>>
cpieig --> tprker : gbrdz
state lrulec <<join>>
tprker --> whfkxg : khvq
whfkxg --> kvncst : shjnm
kvncst --> odiifg : gniqn
odiifg --> lrulec : rubwtfk
tprker --> hevylm : rrmy
hevylm --> kdsvbd : vozxx
kdsvbd --> zcowes : mtagh
zcowes --> lrulec : hbgdmnl
tprker --> hagrch : zezi
hagrch --> okldlt : eaacx
okldlt --> lrulec : mbqekcn
lrulec --> gftcce : fnfwx
gftcce --> ouawbx : ynvrg
state ouawbx {
[*] --> lwufha : slyxq
lwufha --> aboxpv : mzhbo
aboxpv --> hdqrot : wvchr
hdqrot --> thcjza : mdwpa
thcjza --> [*] : rtqwg
}
ouawbx --> mmpccn : pmizm
mmpccn --> hjfqja : hdcna
hjfqja --> [*] : rbase
@enduml