@startuml
hide empty description
state iemtug
[*] --> iemtug : ihfip
iemtug --> lrtafk : xszxj
lrtafk --> stixmq : jvghg
stixmq --> pmhwtf : lgwax
pmhwtf --> afnwob : ggmwz
state afnwob {
nmnisl --> evqtla : wemyl
evqtla --> rifctt : qjygf
rifctt --> [*] : betwy
}
state hpyevw <<choice>>
afnwob --> hpyevw : kpnin
hpyevw --> solvyn : sykg
solvyn --> bzdyyc : hbgol
bzdyyc --> ogrywc : ckjjq
ogrywc --> cpahkv : tzvohcb
hpyevw --> fvwxkp : afub
fvwxkp --> lnbwom : hwojt
lnbwom --> anrubx : yhqgw
anrubx --> dpplfo : sbsey
dpplfo --> cpahkv : cpfmvma
cpahkv --> ddfqfq : zcfgn
ddfqfq --> fhonet : zvuua
state ekzrlq <<fork>>
fhonet --> ekzrlq : rolcl
state bzsaar <<join>>
ekzrlq --> cjqtgw : yrmf
cjqtgw --> ffccfk : kvtxz
ffccfk --> bzsaar : tflmnsn
ekzrlq --> qhaonr : nnpt
qhaonr --> myjpvj : omism
myjpvj --> mqsiyr : mespo
mqsiyr --> udxpsq : bckhw
udxpsq --> bzsaar : qgovvyn
bzsaar --> [*] : hwewt
@enduml