@startuml
state nebqjb
[*] --> nebqjb : zwnec
nebqjb --> cwebhf : fjeyr
cwebhf --> fwmppe : tnbyl
fwmppe --> oqxkzv : imvwy
oqxkzv --> dfafwr : oqdyn
state iflzhg <<fork>>
dfafwr --> iflzhg : bzmjk
state ecjhjg <<join>>
iflzhg --> tboxil : ktay
tboxil --> cfkzmc : ludul
cfkzmc --> fbivsm : ksrdz
fbivsm --> hjchvf : cxwna
hjchvf --> ecjhjg : ljkvstm
iflzhg --> lfnrkv : knlj
lfnrkv --> tojkhc : oznqk
tojkhc --> ecjhjg : ngaxrtw
iflzhg --> vefndg : oene
vefndg --> rqjueo : vijhi
rqjueo --> rxtpuy : neqaj
rxtpuy --> ecjhjg : meymohv
state ytvkgy <<fork>>
ecjhjg --> ytvkgy : jehon
state vzumgz <<join>>
ytvkgy --> quflud : iwhq
quflud --> uhikyg : evwkl
uhikyg --> jcbfbw : znbpr
jcbfbw --> vzumgz : jiatwbo
ytvkgy --> hdbywo : twhe
hdbywo --> qxldwo : wkydw
qxldwo --> vzumgz : lnutgfy
vzumgz --> ygtftj : pjcme
ygtftj --> dalbzs : veczd
dalbzs --> rnxdod : apuuo
state filbub <<fork>>
rnxdod --> filbub : kwdvt
state vvhrpq <<join>>
filbub --> qcgxst : wesm
qcgxst --> mbjhjg : amsvr
mbjhjg --> wzzgcl : ttxut
wzzgcl --> vvhrpq : rhocfij
filbub --> dygfos : ngjt
dygfos --> vbmdek : jdhof
vbmdek --> aozcgw : zqbeo
aozcgw --> hicytp : fzmxg
hicytp --> vvhrpq : gerxmsv
vvhrpq --> kddokn : mcckc
kddokn --> [*] : alpzz
@enduml