@startuml
state xeibpv
xeibpv --> qtmssb : lhzmc
state ggkolp <<choice>>
qtmssb --> ggkolp : ccwcu
ggkolp --> bpopxz : nndz
bpopxz --> vdfboo : mvmxh
vdfboo --> znntbj : uzwqa
znntbj --> pwhiso : wjyjmxh
ggkolp --> lxqruv : zmja
lxqruv --> ucmybc : aotcp
ucmybc --> pjxliu : ybxgw
pjxliu --> wqbwfu : amlsp
wqbwfu --> pwhiso : peqioio
pwhiso --> ixuung : letcf
state ixuung {
[*] --> zbnols : qeeqw
zbnols --> ebkbws : iczha
ebkbws --> [*] : onael
}
ixuung --> zifabk : sryqr
state gckdxl <<choice>>
zifabk --> gckdxl : gpstm
gckdxl --> komgbn : uirl
komgbn --> tuziup : txiwx
tuziup --> bvuxsk : bjpcb
bvuxsk --> utlxco : qauum
utlxco --> lcgwkk : yzsksbu
gckdxl --> flrmyw : gxdu
flrmyw --> ibikbb : dtbuu
ibikbb --> jtsctz : jcvjz
jtsctz --> lcgwkk : wvvcoic
lcgwkk --> crcgdo : fdkmp
state xfytvr <<choice>>
crcgdo --> xfytvr : ucosu
xfytvr --> kkvurk : jepp
kkvurk --> woyjmj : deprr
woyjmj --> esvcsx : jcpgp
esvcsx --> nnmsgd : eaxwl
nnmsgd --> sefuqk : yusvxyg
xfytvr --> pokova : mxac
pokova --> fmcpeo : hijwa
fmcpeo --> bqabuw : phxox
bqabuw --> cvhfmp : pmptb
cvhfmp --> sefuqk : jfrjwde
sefuqk --> [*] : orqka
@enduml