@startuml
state pcrmsc
pcrmsc --> rbcoqx : tledy
rbcoqx --> tqblel : iuewq
tqblel --> hggjjy : gingv
hggjjy --> qbfvnh : uwbfd
state qbfvnh {
[*] --> qtdurq : kbqjx
qtdurq --> akgdns : aylil
}
qbfvnh --> cpdpgh : dnbxo
cpdpgh --> wuioke : fccvf
wuioke --> jkvuua : rmtzz
state jkvuua {
gmnesm --> kniown : hbqzf
kniown --> vmyodq : hphsk
vmyodq --> [*] : vgmpd
}
jkvuua --> lhrurd : lmfvo
state dfpvxp <<fork>>
lhrurd --> dfpvxp : jcwbb
state sbzqvu <<join>>
dfpvxp --> qotyxn : cmfh
qotyxn --> abfawu : zuycp
abfawu --> rdeyvx : ppccg
rdeyvx --> sbzqvu : zhjspga
dfpvxp --> ecxxhi : yufv
ecxxhi --> nlrfdp : cwply
nlrfdp --> eszgkw : xmmvx
eszgkw --> sbzqvu : kbojqdi
sbzqvu --> vkxthe : ofusz
vkxthe --> [*] : ovbrt
@enduml