@startuml
hide empty description
state tbyvdw
[*] --> tbyvdw : edkpn
tbyvdw --> sqpjns : rqrrf
state sqpjns {
ravgru --> xcwdxe : ioxtj
xcwdxe --> kvcuam : lucip
}
sqpjns --> flnszx : bhyzf
flnszx --> iksmvw : mlkpq
iksmvw --> updtao : hwjzs
updtao --> ydfmmu : xicfw
ydfmmu --> zinafp : eyzlu
state zinafp {
oscuol --> wfijqj : bpbie
wfijqj --> zvezuv : jhlaj
zvezuv --> [*] : caqva
}
zinafp --> zxnhdg : tujww
state hwtttn <<choice>>
zxnhdg --> hwtttn : ilupk
hwtttn --> whrfki : natz
whrfki --> nciqiz : epddm
nciqiz --> dfjolr : huhptgy
hwtttn --> vzixbd : ugcr
vzixbd --> bwadrm : erxjw
bwadrm --> dfjolr : brbnuli
dfjolr --> zsyrxo : nmxug
zsyrxo --> kpjtsj : punyv
kpjtsj --> [*] : feeba
@enduml