@startuml
state ntnbky
[*] --> ntnbky : umtzr
ntnbky --> wetdjp : cydrz
wetdjp --> xlewrk : rnojn
xlewrk --> cryqzu : vfjmp
cryqzu --> fuqbjg : ttprt
state hctacr <<fork>>
fuqbjg --> hctacr : xsmvw
state cxuzql <<join>>
hctacr --> sidyqa : lipn
sidyqa --> pmuepg : rvmse
pmuepg --> ptpuxi : babvl
ptpuxi --> bldvsq : ikkfc
bldvsq --> cxuzql : acykdwn
hctacr --> fygsst : ovuy
fygsst --> moxexm : tbhlg
moxexm --> fqbosp : cmrqd
fqbosp --> nbespv : mazuq
nbespv --> cxuzql : xljidiv
hctacr --> nwffqt : qibv
nwffqt --> qfiqcc : uyxms
qfiqcc --> dqghnu : obykq
dqghnu --> cxuzql : llwnuun
cxuzql --> pjhwfn : efgna
pjhwfn --> kmaiep : uwrcj
kmaiep --> zexgbj : tsxkc
zexgbj --> ahnsoy : khbfq
ahnsoy --> wnpmdw : cccqo
wnpmdw --> mqtwcu : boguw
mqtwcu --> rbowzn : cldow
rbowzn --> jdmeni : jbogx
jdmeni --> kmhbxk : zvgwc
@enduml