@startuml
state suzaoy
suzaoy --> bbqzrf : nrqpt
bbqzrf --> denhej : wrzjx
denhej --> auaauy : jrhvt
auaauy --> lbtits : uuonz
lbtits --> mddxfg : zdwxa
mddxfg --> jtbfbm : spgst
jtbfbm --> qqyctu : wdnyc
qqyctu --> qbpumh : tyktb
qbpumh --> ccnagp : mxapg
state pftach <<fork>>
ccnagp --> pftach : ppdqp
state gtezww <<join>>
pftach --> akjoud : fwcf
akjoud --> cqonpj : fidjk
cqonpj --> gtezww : qcycyml
pftach --> tmqvqe : cvkg
tmqvqe --> srtvmy : pycrf
srtvmy --> ucacxa : drhzu
ucacxa --> gtezww : xniqcts
state hrbuop <<choice>>
gtezww --> hrbuop : uogiv
hrbuop --> clifmq : vgpx
clifmq --> txbxqf : kghjm
txbxqf --> cdqepk : wiqbzog
hrbuop --> sztfrc : vwbw
sztfrc --> fqtukf : sqaae
fqtukf --> dqpaks : vncau
dqpaks --> txmeli : hgsmm
txmeli --> cdqepk : fdczwff
@enduml